-1 -1 -1 -1 -1 -1 -1 -1 -1 -1 -1
-1 -1 -1 -1 -1 -1 -1 12 -1 -1 -1
-1 -1 -1 -1 -1 -1 -1 12 13 14 -1
-1 -1  3 -1 -1 -1 -1 11 11 -1 -1
-1 -1  2 -1 -1 -1 -1 11 12 -1 -1
-1  4  1  6  7  8  9 10 -1 -1 -1
-1  5 11 -1 -1 -1 -1 -1 -1 -1 -1
-1 -1 -1 -1 -1 -1 -1 -1 -1 -1 -1
