-1 -1 -1 -1 -1 -1 -1 -1 -1 -1 -1
-1 -1 -1 -1 -1 -1 13 -1 -1 -1 -1
-1 -1 -1 -1 -1 -1 12 14 15 -1 -1
-1 -1  3 -1 -1 -1 12 12 -1 -1 -1
-1 -1  2 -1 -1 -1 12 13 -1 -1 -1
-1  4  1  7  8  9 10 11 -1 -1 -1
-1  5  6 -1 -1 -1 -1 -1 -1 -1 -1
-1 -1 -1 -1 -1 -1 -1 -1 -1 -1 -1

# there are an uneven amount of spaces for alignment purposes
